Date,Description,Category,Amount,Type,Balance,Account Holder,Account Type,Transaction ID
06/11,Marketing Campaign Expens,Marketing Cost,-99.77,other,7809.94,ELIZABETH MIDDLETON,Business,QMUP4934530005
06/14,Sales Revenue Client In,Sales Revenue,208.07,deposit,8018.01,ELIZABETH MIDDLETON,Business,AKBV5282160000
06/21,Refund From Customer Retu,Refund Received,206.6,deposit,8224.61,ELIZABETH MIDDLETON,Business,EFRZ9848450004
06/24,Invoice Payment Office,Office Supplies,-469.39,check,7755.22,ELIZABETH MIDDLETON,Business,MLQD2206780006
06/27,Payroll Employee Wages Ex,Payroll Expense,-278.41,check,7476.81,ELIZABETH MIDDLETON,Business,EATO9886310003
06/28,Client Sales Revenue Rece,Sales Revenue,833.29,deposit,8310.1,ELIZABETH MIDDLETON,Business,UVWA0380290001
06/28,Equipment Purchase New S,Equipment Purchase,-277.21,check,8032.89,ELIZABETH MIDDLETON,Business,WJAH5477650002
