Date,Description,Category,Amount,Type,Balance,Account Holder,Account Type,Transaction ID
06/11,Apartment Rent Payment,Rent Payment,-382.72,electronic,9650.78,ELIZABETH MIDDLETON,Personal,DCMC4391680002
06/14,Apartment Rent Payment,Rent Payment,-115.76,other,9535.02,ELIZABETH MIDDLETON,Personal,DBKQ3313050005
06/16,Tax Refund Credit Person,Tax Refund,635.43,deposit,10170.45,ELIZABETH MIDDLETON,Personal,HGYA3450850000
06/20,Electricity Bill Payment,Utility Payment,-232.86,other,9937.59,ELIZABETH MIDDLETON,Personal,UCTP4295530003
06/26,Rent Payment Due Client,Client Payment,582.64,deposit,10520.23,ELIZABETH MIDDLETON,Personal,XBCH2453890001
06/26,Book Kindle Ebook Purch,Online Purchase,-100.66,electronic,10419.57,ELIZABETH MIDDLETON,Personal,WLOG3559850006
06/28,Friendly Birthday Gift Re,Gift Received,65.39,deposit,10484.96,ELIZABETH MIDDLETON,Personal,HUVE4257750004
