Date,Description,Category,Amount,Balance,Account Holder,Account Type,Transaction ID
06/10,Electricity Bill Payment,Utility Payment,-294.65,16323.81,TIMOTHY MARTINEZ,Personal,GVGD9867530000
06/11,Friendly Gift Received,Gift Received,360.13,16683.94,TIMOTHY MARTINEZ,Personal,IDRK5638910004
06/19,Employer Monthly Salary D,Salary Deposit,623.04,17306.98,TIMOTHY MARTINEZ,Personal,IJZN2244960002
06/21,Apartment Rent Payment,Rent Payment,-117.25,17189.73,TIMOTHY MARTINEZ,Personal,VYYU1406750003
06/23,Friendly Gift Received,Gift Received,61.0,17250.73,TIMOTHY MARTINEZ,Personal,RBDO1384620001
06/25,Electricity Bill Payment,Utility Payment,-458.2,16792.53,TIMOTHY MARTINEZ,Personal,KJQJ6079370005
