Date,Description,Category,Amount,Type,Balance,Account Holder,Account Type,Transaction ID
05/30,Tax Refund Credited,Tax Refund,183.04,deposit,5629.63,ELIZABETH MIDDLETON,Personal,JTMV7108670001
06/01,Rent Payment Due Client,Client Payment,451.28,deposit,6080.91,ELIZABETH MIDDLETON,Personal,JTGG0975100000
06/09,Monthly Streaming Subscri,Subscription Fee,-273.5,check,5807.41,ELIZABETH MIDDLETON,Personal,DTAF5004430004
06/12,Electricity Bill Payment,Utility Payment,-150.5,check,5656.91,ELIZABETH MIDDLETON,Personal,WNFA2360290003
06/15,Employer Monthly Salary D,Salary Deposit,694.67,deposit,6351.58,ELIZABETH MIDDLETON,Personal,HJGH9447630006
06/17,Rent Payment Due Client',Client Payment,878.94,deposit,7230.52,ELIZABETH MIDDLETON,Personal,IPSE7376790005
06/23,Electricity Bill Payment,Utility Payment,-396.73,electronic,6833.79,ELIZABETH MIDDLETON,Personal,RCUG5380300002
