Date,Description,Category,Amount,Type,Balance,Account Holder,Account Type,Transaction ID
05/29,Monthly Subscription Fee,Subscription Fee,-228.54,check,16823.3,ELIZABETH MIDDLETON,Personal,OBVN3833210005
06/05,Milk And Eggs Purchased,Grocery Shopping,-414.95,check,16408.35,ELIZABETH MIDDLETON,Personal,KYGA7870170004
06/10,Apartment Rent Payment,Rent Payment,-374.44,other,16033.91,ELIZABETH MIDDLETON,Personal,KESK8429020002
06/10,Online Bookstore Shopping,Online Purchase,-303.7,check,15730.21,ELIZABETH MIDDLETON,Personal,NRER7034070003
06/14,Refunded Tax Amount 2018,Tax Refund,461.22,deposit,16191.43,ELIZABETH MIDDLETON,Personal,EDLX8665150000
06/14,Personal Gift Received,Gift Received,736.0,deposit,16927.43,ELIZABETH MIDDLETON,Personal,CQHL8847950006
06/26,Rent Payment Due Client,Client Payment,68.56,deposit,16995.99,ELIZABETH MIDDLETON,Personal,BROO5698220001
