Date,Description,Category,Amount,Balance,Account Holder,Transaction ID
05/21,Apartment Rent Payment,Rent Payment,-442.23,18530.920000000002,BURNETT GROUP,QCHE9980860007
05/24,Client Payment Software,Client Payment,861.06,19391.980000000003,BURNETT GROUP,FDBJ3043230008
05/27,Client Payment Rent Inst,Client Payment,438.35,19830.33,BURNETT GROUP,SQGS7318130003
06/01,Digital Goods Acquired,Online Purchase,-324.67,19505.66,BURNETT GROUP,GZNK0659880000
06/02,Tax Refund Credit,Tax Refund,282.86,19788.52,BURNETT GROUP,JZDV5946170004
06/03,Groceries Weekly Shoppi,Grocery Shopping,-475.89,19312.63,BURNETT GROUP,QBYR8871200001
06/05,Amazon Online Purchase,Online Purchase,-143.0,19169.63,BURNETT GROUP,KIUH0486930002
06/07,Groceries Milk Eggs Br,Grocery Shopping,-119.88,19049.75,BURNETT GROUP,DPME6407130005
06/07,Employee Salary Deposit,Salary Deposit,573.31,19623.06,BURNETT GROUP,HXIC0300900006
