Date,Description,Category,Amount,Balance,Account Holder,Transaction ID
05/21,Monthly Salary Deposit,Salary Deposit,259.92,5850.34,BROWN-JONES,BXAB7941490005
05/22,Cash Deposited At Atm,Cash Deposit,122.77,5973.11,BROWN-JONES,ITYX8601640001
05/26,Gift Received From John D,Gift Received,878.4,6851.51,BROWN-JONES,TQIW8954800002
06/04,Tax Refund Credited,Tax Refund,64.99,6916.5,BROWN-JONES,PAKP7171090003
06/06,Online Shopping Transacti,Online Purchase,-303.01,6613.49,BROWN-JONES,TYUK7577250004
06/09,Gift Received From John D,Gift Received,211.59,6825.08,BROWN-JONES,HYFD8762570000
